NO ./input/sprites/texture1.xpm
SO ./input/sprites/texture2.xpm
WE ./input/sprites/texture3.xpm
EA ./input/sprites/texture4.xpm

F 220,100,0 
C 225,30,0  

1111111111111111111111111111111111111111111111111
1000000000000000000000000000000000000000000000001
1000000000000000000000000000000000000000000000001
1000000000000000000000000000000000000000000000001
1000000000000000000000000000000000000000000000001
1000000000N00000000000010000000111111110000000001
1000000000000000000000100000000000000000000000001
1000000000000000000001111111111000000000000000001
1001111111111111111111110000000000000000000000001
1000000000000000000111110000000000000000000000001
1000000011111111111110000000000000000000000000001
1000000011111111000000000000000000000000000000001
1000000011111111111110000000000000000000000000001
1000000000000000000000000000000000000000000000001
1000000000000000000000000000000000000001111111001
1000000000000000000000000000000000000000000000001
1000000000000000000000000000000000000000000000001
1000000000000000001111100000111100000000000000001
1000000000011111111111100000000000000000000000001
1000000000000000000000000000000000000000000000001
1000000000000000000000000000000000000000000000001
1000000000000000000000000000000000000000000000001
1000000000000000000000000000001000000000000000001
1000000000000000000000000000001000000000000000001
1000000000000000000000000000001000000000000000001
1000000000000000000000000000001000000000000000001
1000000000000000000000000000001000000000000000001
1000000000000000111100000000011111000000000000001
1000000000011111111000000000000001000000000000001
1000000000000000000000000000000001000000000000001
1000000000000000000000000000000001111000000000001
1000000000000000000000000000000000001000000000001
1000000000000000000100000000000000001000000000001
1000000000000000000100000000000000001000000000001
1000000000000000000100000000000000000000000000001
1000000111111111111000000000000000000000000000001
1000000000000000000000000000000000000000000000001
1000000000000000000000000000000000000000000000001
1000000000000000000000000000000000000000000000001
1000000000000000000000000000000000000000000000001
1000000000000000000000000000000000000000000000001
1000000000000000000000000000000000000000000000001
1000000000000000000000000000000000000000000000001
1111111111111111111111111111111111111111111111111
